NO ./img/no_wall.xpm
SO ./img/so_wall.xpm
WE ./img/we_wall.xpm
EA ./img/ea_wall.xpm

F 220,100,0
C 225,30,0

11111 111111 111111 1
    100000000000001111111
  1111  0000000000011111
1000000000000000000000001
 00000S000 111100000000 1
1110000000 111110000000001
1111000000     0000000011
11100 0000000 0000 0  01
1 1000000 001111111000011
1 10000000001111111000001
1000001111111000000000011
100 001111111000110000011
111 1111 1111 1111 1111 111