NO ./img/no_wall.xpm
SO ./img/so_wall.xpm
WE ./img/we_wall.xpm
EA ./img/ea_wall.xpm

F 220,100,200
C 225,30,14

1111111111
10000000001
1100000001
1000000111
1001100111
1000111111
1000000111
10S1110111
1001000111
1111111111