NO ./img/no_wall.xpm
SO ./img/so_wall.xpm
WE ./img/we_wall.xpm
EA ./img/ea_wall.xpm

F 220,100,0
C 225,30,0

11111111111
10000000001
110000E0001
10000001101
10011001001
10001100001
10000001101
10011101101
10010000001
11111111111