NO ./img/no_wall.xpm
SO ./img/so_wall.xpm
WE ./img/we_wall.xpm
EA ./img/ea_wall.xpm

F 220,100,200
C 225,30,14

1111111111
1        1
1  S     1
1        1
1        1
1        1
1        1
1        1
1        1
1111111111